R               1440              900 

NO    ./textures/xpm/walls/colorstone.xpm          
SO ./textures/xpm/walls/redbrick.xpm
WE ./textures/xpm/walls/greystone.xpm
EA             ./textures/xpm/walls/wall_white_rock.xpm
S        ./textures/xpm/sprites/box_2.xpm           

F  0,0,0          
C 255 255 0           

                                         11111111111111111
       11111111111111111              11110000000000110001
  1111100000000000000001              10000000000000110001
  1000000011111111100111              10000011111000110001
  10000000000000000001                10000000001000000001
  10011111111111111111                10000111001000000001
  101                                 11111  1001111111111
  101                                        1001
  101   11111111111111111111111111111111111111001
  10111110000000000000110000000000222222222222001
  10000000110000000000110020000000000000000000001
  11111110110000000001110000000000000000000111111
        100100000000000000000000000000000001
111111111011E0000000011100000000000000000001
10000000001100000000011101111101111111111111      111111
111101111111111111011100000010001                 100001
11110111111111111101110101001000111111111111111111100001
11000000110101111101110000001000000000000000000000000001
1000000000000000000011000000100011111100000000001100001
100000000000000000001101010010001    111111100001100001
11000001110101111101111101111000111        100000000001
11110111 11101111101 101111010001          111111111111
11111111 11111111111 111111111111